22222222222222222222
21111111112111121212
21232112212112122112
22222221112112111112
21122211112222211122
21111111111111122112
22211121211212111122
21111121111121112112
22221221111222221222
21212111111221112112
21212121111122121122
21211121111121212112
22212122221112222112
22212111112111111112
21112121121111211212
21212121211212122212
21212121211111141122
21212121221211111112
21222111122121111122
22222222222222222222
