22222222222222222222222222222222222
21111111111111111111111111111111112
21111111111111111111111111111111112
21111111111111111111111111111111112
21111111111111111111111111111111112
21111111111111111111111111111111112
21111111111111111111111111111111112
21111111111111111111111111111111112
21111111111111111111111111111111112
21111111111111111111111111111111112
21111111111111111111111111111111112
21111111111111111211111111111111112
21222222222111111211111111111111112
21211111111111111211111111111111112
21211311111111111211111111111111112
21211111111111111211111111111111112
21211111112111111211111111111111112
21211111112111111211111111111111112
21211111112111111111111111111111112
21211111112111111211111111111111112
21211111112111111111111211111111112
21211111112111111111111211111111112
21211111112111111211111211111111112
21111111111111111211111211111111112
21111111111111111211111211111111112
21111111111111111211111211111211112
21111111111111111211111111111211112
21111111111111111211111111111211112
21111111111111111111111111111211112
21111111111111111111111111111211112
21111111111111111111111111111211112
21111111111111111111111111111211112
21111111111111111111111111111211112
21111111111111111111111111111111142
22222222222222222222222222222222222
