22222222222222222222222222222222222
21111111111111111111111111111111112
21111111111111111111111111111111112
21111111111111111111111111111111112
21111111111111111111111111111111112
21111111111111111111111111111111112
21111111111111111111111111111111112
21111111111111111111111111111111112
21111111111111111111111111111111112
21111111111111111111111111111111112
21111111111111111111111111111111112
21111111111111111111111111111111112
21111111111111111111111111111111112
21111111111111111111111111111111112
21111311111111111111111111111141112
21111111111111111111111111111111112
21111111111111111111111111111111112
21111111111111111111111111111111112
21111111111111111111111111111111112
21111111111111111111111111111111112
21111111111111111111111111111111112
21111111111111111111111111111111112
21111111111111111111111111111111112
21111111111111111111111111111111112
21111111111111111111111111111111112
21111111111111111111111111111111112
21111111111111111111111111111111112
21111111111111111111111111111111112
21111111111111111111111111111111112
21111111111111111111111111111111112
21111111111111111111111111111111112
21111111111111111111111111111111112
21111111111111111111111111111111112
21111111111111111111111111111111112
22222222222222222222222222222222222
