22222222222222222222
21111221112111111112
21222221212112222112
21113111212112111112
22222222212212222222
21111111111111111112
21222222221222222212
21111111221111111112
22222222211222222212
21212111112211111112
21211121122112222222
21212121221111111112
21212121122114112212
21212122112222222112
21212122111111111122
21212122212222211222
21211122111111112212
21212121122222222112
21112121111111111112
22222222222222222222
