22222222222222222222222222222222222
21111111111111111121112111112212142
21111112111111111121112111212111112
21111111121111111121112111211121212
21222111121111111121111111212112112
21111111121111111121122222222222212
21111111121111111121111111111121112
21122211121212121121111112111121112
21111122211112121111111112111111222
21111111211121122222221112111111212
21111111211211221111111112222221112
21111111212112121122222222222222222
21111111221121121111111112111111112
21111111111211121111111112111111212
21112221222222221111111112111212112
21112121121111111121111112111221112
21111121121111222121111112112222112
21111121121121111121111112111211112
21112111121121211121111112111211112
21112111111121211121111112111211112
21112222221121122221111122111111112
21112111111121111121112222222222212
21112111111121111121111121111111112
21112111111121121121111121111111112
21112111111111121121111121111111112
21112111111111121121111121112111112
21112111122222221121111121112111112
21112111111211111121111121112111112
21222111111212111121111121112111112
21222111111211111111111111112111112
21112111222222222222222211112111112
22112111111121111111111111112111112
21112111111122222111111111112111112
23112111111111111111111111111111112
22222222222222222222222222222222222
