1111111122
3122122111
1212222221
1111111211
2122121111
2121122221
1111221111
2121221141
1121111121
2111121111
