3121112122
1122122121
1212222221
1111111222
2122121112
2121122211
1111221122
2121221124
1122211121
2111111111
