2222222222222222222222222222222222222222
2111111111111121111111111111111111111112
2111111122122211111111122221112222222222
2112111121122211121111111111211111111112
2112111211111111121112222212222112222212
2112112211111211121111111111111111111122
2112122112211211121121112211112221111122
2112121112211211221121112211212112222112
2112211112211211211221112211212111211122
2111111112211211211211111111211111111112
2111211112211112211211212222222222222122
2111111112211112111111211111211121211112
2121112112211111112221211222211111211112
2121112112211211212111211211111121111112
2121112222211212111112211111122211112122
2121111122211212121212221211111211112222
2121111122231111121211222221121222112212
2122111122222221121222211211121112222212
2221221122111111211111211111121412211112
2222111122111122222122211211121112211112
2221111111111111111111211111111222111122
2111111122111111121111211211112222111222
2111111122111111121111211211122211221112
2111111122211111122222111111222112211112
2111111122211122221111111122211122111112
2111111222211111121111111112111221112222
2111112222211111121111111212111211111122
2111112222222222111111112211111211122122
2111122222211111111111122111112211222222
2111122222211111111112221112111111211112
2111122222211111212222111111111221111112
2111222222111112212221111121112211111112
2111222222111111112211111122211111111112
2111222222222222222222111122111111111112
2112222221111111111111111222111111111112
2112222222211111111111111121111111111112
2112111111222222222222221222222212212222
2112111111111121111111111222111111111112
2111111111111111121111111111111111111122
2222222222222222222222222222222222222222
